קירצונגען דָאשִׁי תָבוֹת

דר
דער
הוו
וו
זאָאָל
מצ
באָמ
נעג
פּאָס
פּאָרט
פנ
פּראָג
פרעפ
פר
פּרעפּ
צוו
קאָג
קאָנוו

אַקוזאָטיוו -- יַחֵס הַפָּעוּל

און אַנדערע -- וְאַחָרִים

און אַזוי ווייטער - וְכוּלִי

אַדװערב -- תֹאַר-הַפֹּעַל

אַדיעקטיוו -- תֹּאַריחַשֵׁם

אומפּערזענלעך -- בִּלְתִּי אִישִׁי

אינװאַריאַנט -- לא מִשְׁתַּנֶּה, קְבוּעַ
אינטעריעקציע -- מֵלַת קְריאָה

אַסטראָנאָמיע -- אַסְטְרוֹנוֹמְיָה

פרעדיקאַטיווער אַדיעקטיוו - תֹּאַריהֲשֵׁם נְשׂוּאִי
אַרטיקל -- תָּוִית

באָטאַניק -- בוֹטָנִיקָה

דאַטיו -- צְּטיבוּס, יַחֵס אֶל

זאַכװאָרט פון נײַטראָלן מין -- שֵׁם-עָצָם מִמִין סְתָמֵי
זאַכװאָרט פֿון װײַבלעכן מין -- שִׁמיעֶצָם מִמִין נְקְבָה
זאַכװאָרט פֿון מענלעבן מין -- שֵׁם-עֶצֶם מַמִּין וָכָר
חילפוואָרט -- מִלַּת עֵזֶר

ווערב, צײַטװאָרט -- פֹּעַל

זאָאָלאָגיע -- זוֹאוֹלוֹגִיָה

מערצאָל -- לְשׁוֹן רַבִּים

נאָמינאַטיוו -- יֵחַס יָשֶׁר

נעגאַטיו -- שְׁלֵילִי

פּאָסעסיוו -- ימס הקנין

פּאַרטיקל -- מִלַּת הַטַּעַם

פּריוואַטינאָמען -- שֵׁם פִּרְטִי

פּראָנאָם -- כְּנוּי

פּרעפּאָזיציע -- מִלַּת יַחֵס

פֿראַזע -- מַמְרָה

פּרעפֿיקס -- קדֹמֶת

צאָלװאָרט -- שֵׁם מִסְפָּר

קאָניונקציע -- מַלַּת הַחִבּוּד

קאָנווערב -- תּאַרְהַפּעַל נְשוּאִי

 
 

 

 

 
